19
22
###################
#........#........#
#.###.##.#.##.###.#
#o###.##.#.##.###o#
#.................#
#.###.#.###.#.###.#
#.....#..#..#.....#
#####.##.#.##.#####
    #.#     #.#
#####.#  C  #.#####
        BIN
#####.#     #.#####
    #.#     #.#
#####.#.###.#.#####
#........#........#
#.###.##.#.##.###.#
#o..#....P....#..o#
###.#.#.###.#.#.###
#.....#..#..#.....#
#.######.#.######.#
#.................#
###################