19
22
###################
#........#........#
#.###.##.#.##.###.#
#o###.##.#.##.###o#
#.................#
#.###.#.###.#.###.#
#.....#..#..#.....#
#####.##.#.##.#####
    #.#.....#.#        
#####.#.....#.#####

#####.#.....#.#####
    #.#.....#.#
#####.#.###.#.#####
#........#........#
#.###.##.#.##.###.#
#o..#.........#..o#
###.#.#.###.#.#.###
#.....#..#..#.....#
#.######.#.######.#
#.................#
###################